1 0 0 0 0 0 0 0 0 0 0 0 0 0 0 2
3 8 8 8 8 8 8 8 8 8 8 8 8 8 8 7
3 8 8 8 8 8 8 8 8 8 8 8 8 8 8 7
3 8 8 8 8 8 8 8 8 8 8 8 8 8 8 7
3 8 8 8 8 8 8 8 9 8 9 8 9 8 8 7
3 8 8 8 8 8 8 8 8 8 8 8 8 8 8 7
3 8 8 8 8 8 8 8 9 8 9 8 9 8 8 7
3 8 8 8 8 8 8 8 8 8 8 8 8 8 8 7
3 8 8 8 8 8 8 8 8 8 8 8 8 8 8 7
3 8 8 8 8 8 8 8 8 8 8 8 8 8 8 7
3 8 8 8 8 8 8 8 8 8 8 8 8 8 8 7
4 5 5 5 5 5 5 5 5 5 5 5 5 5 5 6